Dispositivos,Profundidad,Paquete_Enviado,Paquete_Recibido,Tiempo_Envio,Tiempo_Recibido,Terminal_de_Envio,Terminal_de_recibido,Latencia
16, 14, 548000aa, 2548000aa, 145, 225, 3, 11, 80
16, 14, 105af492, 3105af492, 1695, 1715, 0, 4, 20
16, 14, 1004ed4a, 31004ed4a, 2255, 2345, 0, 4, 90
16, 14, 4229c58, 4229c58, 2875, 3195, 0, 3, 320
16, 14, 40cf025a, 340cf025a, 3515, 3665, 0, 7, 150
16, 14, 1548c26, 1548c26, 4215, 4305, 0, 0, 90
16, 14, 2013f17f, 32013f17f, 4905, 5085, 0, 5, 180
16, 14, 30d30f01, 330d30f01, 5565, 5835, 0, 6, 270
16, 14, 40a17d72, 340a17d72, 6205, 6565, 0, 7, 360
16, 14, 53881111, 253881111, 6865, 7385, 0, 10, 520
16, 14, 40bce6a, 40bce6a, 7525, 7885, 0, 3, 360
16, 14, 158468c3, 1158468c3, 8145, 8505, 0, 12, 360
16, 14, 4025085b, 34025085b, 8825, 9185, 0, 7, 360
16, 14, 202c4e26, 3202c4e26, 9475, 9655, 0, 5, 180
16, 14, 402646d0, 3402646d0, 10165, 10525, 0, 7, 360
16, 14, 20acf5e6, 320acf5e6, 10815, 10895, 1, 5, 80
16, 14, 199d50a, 199d50a, 11365, 11485, 1, 0, 120
16, 14, 3cfcd53, 3cfcd53, 12025, 12205, 1, 2, 180
16, 14, 2953fcf, 2953fcf, 12645, 12735, 1, 1, 90
16, 14, 15dd8d75, 115dd8d75, 13325, 13595, 1, 12, 270
16, 14, 542bacc9, 2542bacc9, 14015, 14555, 1, 11, 540
16, 14, 359be5ca, 1359be5ca, 14715, 15065, 1, 14, 350
16, 14, 2e2a5c9, 2e2a5c9, 15385, 15475, 1, 1, 90
16, 14, 45c4150e, 145c4150e, 15995, 16455, 1, 15, 460
16, 14, 523b7b77, 2523b7b77, 16665, 17025, 1, 9, 360
16, 14, 3050362f, 33050362f, 17295, 17635, 1, 6, 340
16, 14, 5402065f, 25402065f, 17985, 18405, 1, 11, 420
16, 14, 159f2854, 1159f2854, 18645, 18915, 1, 12, 270
16, 14, 51576772, 251576772, 19325, 19775, 1, 8, 450
16, 14, 154b92fd, 1154b92fd, 20035, 20155, 2, 12, 120
16, 14, 143f4e4, 143f4e4, 20645, 20855, 2, 0, 210
16, 14, 3594778, 3594778, 21355, 21445, 2, 2, 90
16, 14, 3e07c94, 3e07c94, 22065, 22155, 2, 2, 90
16, 14, 3061be7, 3061be7, 22735, 22825, 2, 2, 90
16, 14, 15fe4fc8, 115fe4fc8, 23355, 23535, 2, 12, 180
16, 14, 36e4b5d, 36e4b5d, 24055, 24145, 2, 2, 90
16, 14, 536a10e3, 2536a10e3, 24765, 24935, 2, 10, 170
16, 14, 3548856a, 13548856a, 25425, 25785, 2, 14, 360
16, 14, 35d879b8, 135d879b8, 26055, 26395, 2, 14, 340
16, 14, 451bd92b, 1451bd92b, 26765, 27155, 2, 15, 390
16, 14, 350669ea, 1350669ea, 27375, 27735, 2, 14, 360
16, 14, 25f39ffd, 125f39ffd, 28025, 28275, 2, 13, 250
16, 14, 4dc8b4b, 4dc8b4b, 28695, 28875, 2, 3, 180
16, 14, 51d61a09, 251d61a09, 29375, 29705, 3, 8, 330
16, 14, 35fb654c, 135fb654c, 29955, 30225, 3, 14, 270
16, 14, 528159e0, 2528159e0, 30635, 31175, 3, 9, 540
16, 14, 3765c7b, 3765c7b, 31285, 31405, 3, 2, 120
16, 14, 48af7bd, 48af7bd, 31965, 32055, 3, 3, 90
16, 14, 25c0e8c4, 125c0e8c4, 32615, 32795, 3, 13, 180
16, 14, 52050f01, 252050f01, 33315, 33835, 3, 9, 520
16, 14, 10b048c1, 310b048c1, 33955, 34315, 3, 4, 360
16, 14, 10a5e526, 310a5e526, 34665, 35025, 3, 4, 360
16, 14, 1045945a, 31045945a, 35275, 35635, 3, 4, 360
16, 14, 5284b416, 25284b416, 35895, 36375, 3, 9, 480
16, 14, 358a8c09, 1358a8c09, 36565, 36835, 3, 14, 270
16, 14, 40fe3db5, 340fe3db5, 37225, 37855, 3, 7, 630
16, 14, 258c74df, 1258c74df, 37895, 38075, 3, 13, 180
16, 14, 259d558f, 1259d558f, 38605, 38955, 4, 13, 350
16, 14, 3005ae39, 33005ae39, 39245, 39515, 4, 6, 270
16, 14, 5256b66f, 25256b66f, 39885, 40215, 4, 9, 330
16, 14, 53fdb2dc, 253fdb2dc, 40555, 41015, 4, 10, 460
16, 14, 1612fcd, 1612fcd, 41165, 41255, 4, 0, 90
16, 14, 547e4749, 2547e4749, 41775, 42285, 4, 11, 510
16, 14, 253ef4c3, 1253ef4c3, 42415, 42865, 4, 13, 450
16, 14, 256093b4, 1256093b4, 43085, 43535, 4, 13, 450
16, 14, 52658617, 252658617, 43795, 44185, 4, 9, 390
16, 14, 15df5baa, 115df5baa, 44465, 44825, 4, 12, 360
16, 14, 35fd0dfa, 135fd0dfa, 45075, 45555, 4, 14, 480
16, 14, 10df2872, 310df2872, 45765, 45855, 4, 4, 90
16, 14, 466bf08, 466bf08, 46385, 46745, 4, 3, 360
16, 14, 156779b, 156779b, 47015, 47105, 4, 0, 90
16, 14, 25451ff4, 125451ff4, 47635, 47935, 5, 13, 300
16, 14, 4582f2d7, 14582f2d7, 48325, 48825, 5, 15, 500
16, 14, 2065a61c, 32065a61c, 49005, 49095, 5, 5, 90
16, 14, 51e3f07d, 251e3f07d, 49655, 49925, 5, 8, 270
16, 14, 1055052d, 31055052d, 50355, 50515, 5, 4, 160
16, 14, 23b48e9, 23b48e9, 51005, 51255, 5, 1, 250
16, 14, 51ffc339, 251ffc339, 51655, 51925, 5, 8, 270
16, 14, 256d6a77, 1256d6a77, 52325, 52685, 5, 13, 360
16, 14, 15e178f1, 115e178f1, 52985, 53375, 5, 12, 390
16, 14, 45f13a21, 145f13a21, 53645, 54185, 5, 15, 540
16, 14, 12026d3, 12026d3, 54295, 54475, 5, 0, 180
16, 14, 40fca721, 340fca721, 54935, 55205, 5, 7, 270
16, 14, 4051f0ee, 34051f0ee, 55645, 55915, 5, 7, 270
16, 14, 3073ac8c, 33073ac8c, 56255, 56435, 5, 6, 180
16, 14, 255ff5f8, 1255ff5f8, 56965, 57375, 6, 13, 410
16, 14, 263615f, 263615f, 57605, 57925, 6, 1, 320
16, 14, 54401a1f, 254401a1f, 58265, 58655, 6, 11, 390
16, 14, 53ced884, 253ced884, 58875, 59235, 6, 10, 360
16, 14, 35afc00f, 135afc00f, 59585, 59945, 6, 14, 360
16, 14, 198f136, 198f136, 60255, 60505, 6, 0, 250
16, 14, 54808e21, 254808e21, 60925, 61355, 6, 11, 430
16, 14, 25a7ff86, 125a7ff86, 61605, 61935, 6, 13, 330
16, 14, 53367b4e, 253367b4e, 62215, 62515, 6, 10, 300
16, 14, 354a22ec, 1354a22ec, 62925, 63285, 6, 14, 360
16, 14, 209c44df, 3209c44df, 63605, 63785, 6, 5, 180
16, 14, 10abfa2f, 310abfa2f, 64305, 64575, 6, 4, 270
16, 14, 2080c7f, 2080c7f, 64975, 65315, 6, 1, 340
16, 14, 300f8971, 3300f8971, 65595, 65685, 6, 6, 90
16, 14, 20c0b0e0, 320c0b0e0, 66305, 66535, 7, 5, 230
16, 14, 30fd72d6, 330fd72d6, 66985, 67165, 7, 6, 180
16, 14, 12a13a7, 12a13a7, 67675, 68035, 7, 0, 360
16, 14, 250873b3, 1250873b3, 68345, 68825, 7, 13, 480
16, 14, 200d5ded, 3200d5ded, 69055, 69325, 7, 5, 270
16, 14, 53c84448, 253c84448, 69755, 70025, 7, 10, 270
16, 14, 40df79d6, 340df79d6, 70395, 70485, 7, 7, 90
16, 14, 463f153, 463f153, 71035, 71645, 7, 3, 610
16, 14, 15617a6, 15617a6, 71685, 72045, 7, 0, 360
16, 14, 53d6be7f, 253d6be7f, 72295, 72565, 7, 10, 270
16, 14, 539000ae, 2539000ae, 72945, 73215, 7, 10, 270
16, 14, 1d2e860, 1d2e860, 73615, 73975, 7, 0, 360
16, 14, 3060f2fe, 33060f2fe, 74225, 74405, 7, 6, 180
16, 14, 2ebde57, 2ebde57, 74835, 75225, 7, 1, 390
16, 14, 30af81c6, 330af81c6, 75535, 75695, 8, 6, 160
16, 14, 45eb8d52, 145eb8d52, 76135, 76495, 8, 15, 360
16, 14, 35dbcd58, 135dbcd58, 76745, 77135, 8, 14, 390
16, 14, 2193698, 2193698, 77445, 77855, 8, 1, 410
16, 14, 205b9e81, 3205b9e81, 78095, 78365, 8, 5, 270
16, 14, 159997e4, 1159997e4, 78705, 79215, 8, 12, 510
16, 14, 527da0b9, 2527da0b9, 79365, 79545, 8, 9, 180
16, 14, 3504a870, 13504a870, 80045, 80475, 8, 14, 430
16, 14, 53824b8a, 253824b8a, 80665, 80935, 8, 10, 270
16, 14, 106c5383, 3106c5383, 81285, 81645, 8, 4, 360
16, 14, 535d97e6, 2535d97e6, 81945, 82215, 8, 10, 270
16, 14, 1034005d, 31034005d, 82555, 82915, 8, 4, 360
16, 14, 51196431, 251196431, 83225, 83315, 8, 8, 90
16, 14, 30fef3e, 30fef3e, 83885, 84365, 8, 2, 480
16, 14, 12b628e, 12b628e, 84495, 84905, 9, 0, 410
16, 14, 53702720, 253702720, 85155, 85335, 9, 10, 180
16, 14, 25c76f03, 125c76f03, 85825, 86155, 9, 13, 330
16, 14, 547c8fd5, 2547c8fd5, 86515, 86785, 9, 11, 270
16, 14, 5350fdb7, 25350fdb7, 87175, 87355, 9, 10, 180
16, 14, 301ef6c, 301ef6c, 87805, 88235, 9, 2, 430
16, 14, 35ed96f0, 135ed96f0, 88455, 88695, 9, 14, 240
16, 14, 25ebb170, 125ebb170, 89065, 89455, 9, 13, 390
16, 14, 5466c511, 25466c511, 89745, 90015, 9, 11, 270
16, 14, 25bf4b24, 125bf4b24, 90455, 90905, 9, 13, 450
16, 14, 2040fc37, 32040fc37, 91065, 91425, 9, 5, 360
16, 14, 35730677, 135730677, 91725, 92065, 9, 14, 340
16, 14, 153f65a4, 1153f65a4, 92365, 92865, 9, 12, 500
16, 14, 214bc81, 214bc81, 93045, 93385, 9, 1, 340
16, 14, 54b4840f, 254b4840f, 93715, 93875, 10, 11, 160
16, 14, 15036b62, 115036b62, 94305, 94755, 10, 12, 450
16, 14, 25e62690, 125e62690, 95015, 95275, 10, 13, 260
16, 14, 45f5998e, 145f5998e, 95625, 95805, 10, 15, 180
16, 14, 306cb7ff, 3306cb7ff, 96315, 96655, 10, 6, 340
16, 14, 5144564c, 25144564c, 97005, 97275, 10, 8, 270
16, 14, 51e9c0fd, 251e9c0fd, 97675, 97945, 10, 8, 270
16, 14, 45a45b31, 145a45b31, 98365, 98545, 10, 15, 180
16, 14, 38d8033, 38d8033, 99005, 99365, 10, 2, 360
16, 14, 13b3bb0, 13b3bb0, 99635, 100175, 10, 0, 540
16, 14, 5358be6e, 25358be6e, 100335, 100425, 10, 10, 90
16, 14, 5433e781, 25433e781, 101035, 101215, 10, 11, 180
16, 14, 255261e1, 1255261e1, 101705, 102045, 10, 13, 340
16, 14, 408fdf2, 408fdf2, 102395, 102845, 10, 3, 450
16, 14, 51283228, 251283228, 103075, 103395, 11, 8, 320
16, 14, 54b195bf, 254b195bf, 103705, 103795, 11, 11, 90
16, 14, 453782a2, 1453782a2, 104405, 104495, 11, 15, 90
16, 14, 22e26c4, 22e26c4, 105115, 105655, 11, 1, 540
16, 14, 53fd1d75, 253fd1d75, 105795, 105975, 11, 10, 180
16, 14, 546ec5d2, 2546ec5d2, 106475, 106565, 11, 11, 90
16, 14, 20fd4aba, 320fd4aba, 107105, 107585, 11, 5, 480
16, 14, 517f5fb4, 2517f5fb4, 107805, 108165, 11, 8, 360
16, 14, 255fa938, 1255fa938, 108475, 108745, 11, 13, 270
16, 14, 54e61e58, 254e61e58, 109125, 109215, 11, 11, 90
16, 14, 25af0c62, 125af0c62, 109805, 110075, 11, 13, 270
16, 14, 309ba6e7, 3309ba6e7, 110415, 110805, 11, 6, 390
16, 14, 547a19ea, 2547a19ea, 111025, 111115, 11, 11, 90
16, 14, 4de5f36, 4de5f36, 111675, 112035, 11, 3, 360
16, 14, 403fc169, 3403fc169, 112385, 112875, 12, 7, 490
16, 14, 45e543d0, 145e543d0, 112995, 113235, 12, 15, 240
16, 14, 4b892a1, 4b892a1, 113625, 113715, 12, 3, 90
16, 14, 20814688, 320814688, 114245, 114635, 12, 5, 390
16, 14, 54c10692, 254c10692, 114895, 115255, 12, 11, 360
16, 14, 1b62056, 1b62056, 115575, 115935, 12, 0, 360
16, 14, 10286659, 310286659, 116245, 116605, 12, 4, 360
16, 14, 3089f857, 33089f857, 116865, 117345, 12, 6, 480
16, 14, 1080e556, 31080e556, 117525, 117885, 12, 4, 360
16, 14, 539b8708, 2539b8708, 118175, 118625, 12, 10, 450
16, 14, 10e27eef, 310e27eef, 118855, 119215, 12, 4, 360
16, 14, 15000f5c, 115000f5c, 119565, 119655, 12, 12, 90
16, 14, 462d9f0, 462d9f0, 120175, 120265, 12, 3, 90
16, 14, 20ffef5d, 320ffef5d, 120865, 121315, 12, 5, 450
16, 14, 15da6c75, 115da6c75, 121475, 121535, 13, 12, 60
16, 14, 204dec81, 3204dec81, 122045, 122405, 13, 5, 360
16, 14, 20ac8dc3, 320ac8dc3, 122725, 123085, 13, 5, 360
16, 14, 4725af5, 4725af5, 123345, 123525, 13, 3, 180
16, 14, 357ce7e4, 1357ce7e4, 124035, 124215, 13, 14, 180
16, 14, 43274ce, 43274ce, 124685, 124865, 13, 3, 180
16, 14, 4915332, 4915332, 125315, 125495, 13, 3, 180
16, 14, 4529111, 4529111, 125935, 126115, 13, 3, 180
16, 14, 3038feb5, 33038feb5, 126575, 127005, 13, 6, 430
16, 14, 517f717e, 2517f717e, 127285, 127825, 13, 8, 540
16, 14, 4503a573, 14503a573, 127965, 128235, 13, 15, 270
16, 14, 35db772b, 135db772b, 128675, 128855, 13, 14, 180
16, 14, 454e5e47, 1454e5e47, 129305, 129575, 13, 15, 270
16, 14, 53b5088a, 253b5088a, 130015, 130375, 13, 10, 360
16, 14, 258f1af4, 1258f1af4, 130705, 130765, 14, 13, 60
16, 14, 54fb5cc5, 254fb5cc5, 131345, 131525, 14, 11, 180
16, 14, 45a2db8, 45a2db8, 132025, 132295, 14, 3, 270
16, 14, 20b2191b, 320b2191b, 132635, 133085, 14, 5, 450
16, 14, 1d65710, 1d65710, 133325, 133865, 14, 0, 540
16, 14, 4afeec2, 4afeec2, 133945, 134215, 14, 3, 270
16, 14, 306a8401, 3306a8401, 134635, 134935, 14, 6, 300
16, 14, 2083580a, 32083580a, 135265, 135715, 14, 5, 450
16, 14, 10d6cc73, 310d6cc73, 135875, 136415, 14, 4, 540
16, 14, 34668b6, 34668b6, 136575, 136815, 14, 2, 240
16, 14, 101c13e0, 3101c13e0, 137205, 137625, 14, 4, 420
16, 14, 3027d268, 33027d268, 137855, 138215, 14, 6, 360
16, 14, 40cba3a0, 340cba3a0, 138485, 138875, 14, 7, 390
16, 14, 30e1dc88, 330e1dc88, 139155, 139515, 14, 6, 360
16, 14, 254bf9c, 254bf9c, 139795, 140095, 15, 1, 300
16, 14, 433fe53, 433fe53, 140385, 140685, 15, 3, 300
16, 14, 399ee89, 399ee89, 141085, 141515, 15, 2, 430
16, 14, 1b9663d, 1b9663d, 141795, 142385, 15, 0, 590
16, 14, 301ea43f, 3301ea43f, 142485, 142875, 15, 6, 390
16, 14, 25410ba9, 125410ba9, 143175, 143445, 15, 13, 270
16, 14, 3537a9e8, 13537a9e8, 143845, 144025, 15, 14, 180
16, 14, 1540dc52, 11540dc52, 144505, 144865, 15, 12, 360
16, 14, 539b8518, 2539b8518, 145155, 145335, 15, 10, 180
16, 14, 45c0680, 45c0680, 145785, 146145, 15, 3, 360
16, 14, 20d5e014, 320d5e014, 146475, 146955, 15, 5, 480
16, 14, 2536aeae, 12536aeae, 147135, 147405, 15, 13, 270
16, 14, 30116a95, 330116a95, 147845, 148295, 15, 6, 450
16, 14, 2a704a3, 2a704a3, 148555, 149095, 15, 1, 540
16, 14, 1394422, 1394422, 151755, 151825, 0, 0, 70
16, 14, 250d399, 250d399, 152445, 152585, 0, 1, 140
16, 14, 36dfeb4, 36dfeb4, 153145, 153375, 0, 2, 230
16, 14, 44e178b, 44e178b, 153785, 154085, 0, 3, 300
16, 14, 10332d13, 310332d13, 154425, 154515, 0, 4, 90
16, 14, 206946ec, 3206946ec, 155075, 155235, 0, 5, 160
16, 14, 30046d91, 330046d91, 155725, 155935, 0, 6, 210
16, 14, 400b10a1, 3400b10a1, 156435, 156775, 0, 7, 340
16, 14, 51305b17, 251305b17, 157075, 157435, 0, 8, 360
16, 14, 524cd054, 2524cd054, 157755, 158105, 0, 9, 350
16, 14, 5365c6a0, 25365c6a0, 158455, 158895, 0, 10, 440
16, 14, 545ce689, 2545ce689, 159155, 159665, 0, 11, 510
16, 14, 152c7270, 1152c7270, 159855, 160215, 0, 12, 360
16, 14, 251c10c0, 1251c10c0, 160565, 161015, 0, 13, 450
16, 14, 355e2278, 1355e2278, 161215, 161755, 0, 14, 540
16, 14, 4579d129, 14579d129, 161885, 162515, 0, 15, 630
16, 14, 1452ba7, 1452ba7, 162525, 162585, 1, 0, 60
16, 14, 2453210, 2453210, 163125, 163215, 1, 1, 90
16, 14, 3086e70, 3086e70, 163805, 163985, 1, 2, 180
16, 14, 473eb6c, 473eb6c, 164485, 164755, 1, 3, 270
16, 14, 106043e7, 3106043e7, 165135, 165315, 1, 4, 180
16, 14, 20530486, 320530486, 165815, 166085, 1, 5, 270
16, 14, 3063e84c, 33063e84c, 166485, 166845, 1, 6, 360
16, 14, 406d7cf5, 3406d7cf5, 167105, 167555, 1, 7, 450
16, 14, 51262eac, 251262eac, 167795, 168245, 1, 8, 450
16, 14, 5224a6de, 25224a6de, 168405, 168765, 1, 9, 360
16, 14, 53028b6d, 253028b6d, 169105, 169555, 1, 10, 450
16, 14, 542282b7, 2542282b7, 169745, 170285, 1, 11, 540
16, 14, 156f34a2, 1156f34a2, 170395, 170665, 1, 12, 270
16, 14, 25432a54, 125432a54, 171065, 171425, 1, 13, 360
16, 14, 3531a91d, 13531a91d, 171705, 172155, 1, 14, 450
16, 14, 45309aad, 145309aad, 172415, 172955, 1, 15, 540
16, 14, 17b7825, 17b7825, 173105, 173255, 2, 0, 150
16, 14, 25bf91c, 25bf91c, 173685, 173865, 2, 1, 180
16, 14, 34d8c97, 34d8c97, 174345, 174435, 2, 2, 90
16, 14, 461e911, 461e911, 174955, 175135, 2, 3, 180
16, 14, 10574b44, 310574b44, 175655, 175925, 2, 4, 270
16, 14, 20292a66, 320292a66, 176315, 176675, 2, 5, 360
16, 14, 30696466, 330696466, 177025, 177475, 2, 6, 450
16, 14, 4021682d, 34021682d, 177665, 178205, 2, 7, 540
16, 14, 511d93d8, 2511d93d8, 178335, 178875, 2, 8, 540
16, 14, 5211828a, 25211828a, 178945, 179395, 2, 9, 450
16, 14, 534eec09, 2534eec09, 179655, 180015, 2, 10, 360
16, 14, 547ec7b2, 2547ec7b2, 180275, 180725, 2, 11, 450
16, 14, 15323730, 115323730, 180895, 181075, 2, 12, 180
16, 14, 251e12d8, 1251e12d8, 181605, 181875, 2, 13, 270
16, 14, 357432d0, 1357432d0, 182275, 182635, 2, 14, 360
16, 14, 451f1671, 1451f1671, 182885, 183335, 2, 15, 450
16, 14, 1617743, 1617743, 183505, 183745, 3, 0, 240
16, 14, 271f690, 271f690, 184085, 184355, 3, 1, 270
16, 14, 379a15f, 379a15f, 184705, 184885, 3, 2, 180
16, 14, 40be42b, 40be42b, 185345, 185435, 3, 3, 90
16, 14, 10029292, 310029292, 185975, 186335, 3, 4, 360
16, 14, 205a8dc1, 3205a8dc1, 186585, 187035, 3, 5, 450
16, 14, 303da27b, 3303da27b, 187285, 187825, 3, 6, 540
16, 14, 40523ce2, 340523ce2, 187955, 188585, 3, 7, 630
16, 14, 512abb69, 2512abb69, 188665, 189295, 3, 8, 630
16, 14, 5249b134, 25249b134, 189355, 189895, 3, 9, 540
16, 14, 537e7570, 2537e7570, 190005, 190455, 3, 10, 450
16, 14, 545920cb, 2545920cb, 190705, 191065, 3, 11, 360
16, 14, 154f916b, 1154f916b, 191395, 191485, 3, 12, 90
16, 14, 2574bcdf, 12574bcdf, 192055, 192235, 3, 13, 180
16, 14, 3538236d, 13538236d, 192715, 192985, 3, 14, 270
16, 14, 454b0a8a, 1454b0a8a, 193325, 193685, 3, 15, 360
16, 14, 16cae47, 16cae47, 194005, 194055, 4, 0, 50
16, 14, 265dd90, 265dd90, 194625, 194765, 4, 1, 140
16, 14, 3781b99, 3781b99, 195265, 195495, 4, 2, 230
16, 14, 46901c0, 46901c0, 195875, 196215, 4, 3, 340
16, 14, 100a6ab3, 3100a6ab3, 196555, 196645, 4, 4, 90
16, 14, 2055fce6, 32055fce6, 197195, 197375, 4, 5, 180
16, 14, 304469a6, 3304469a6, 197895, 198165, 4, 6, 270
16, 14, 402335d9, 3402335d9, 198505, 198865, 4, 7, 360
16, 14, 511db210, 2511db210, 199125, 199485, 4, 8, 360
16, 14, 52490481, 252490481, 199755, 200205, 4, 9, 450
16, 14, 5320b599, 25320b599, 200395, 200935, 4, 10, 540
16, 14, 5407a240, 25407a240, 201005, 201635, 4, 11, 630
16, 14, 155a14ae, 1155a14ae, 201615, 201975, 4, 12, 360
16, 14, 2520ef9d, 12520ef9d, 202295, 202745, 4, 13, 450
16, 14, 35689160, 135689160, 203005, 203545, 4, 14, 540
16, 14, 45497d21, 145497d21, 203625, 204255, 4, 15, 630
16, 14, 139b708, 139b708, 204235, 204375, 5, 0, 140
16, 14, 231a7f2, 231a7f2, 204885, 205115, 5, 1, 230
16, 14, 325794b, 325794b, 205565, 205885, 5, 2, 320
16, 14, 41738e8, 41738e8, 206235, 206645, 5, 3, 410
16, 14, 1058592d, 31058592d, 206925, 207105, 5, 4, 180
16, 14, 204604e4, 3204604e4, 207585, 207675, 5, 5, 90
16, 14, 3052a0f1, 33052a0f1, 208215, 208395, 5, 6, 180
16, 14, 4040564f, 34040564f, 208835, 209105, 5, 7, 270
16, 14, 51319158, 251319158, 209455, 209725, 5, 8, 270
16, 14, 5223153c, 25223153c, 210065, 210425, 5, 9, 360
16, 14, 530a62a6, 2530a62a6, 210765, 211215, 5, 10, 450
16, 14, 54603a24, 254603a24, 211385, 211925, 5, 11, 540
16, 14, 156cc94a, 1156cc94a, 211995, 212445, 5, 12, 450
16, 14, 25778868, 125778868, 212695, 213055, 5, 13, 360
16, 14, 353990f3, 1353990f3, 213375, 213825, 5, 14, 450
16, 14, 45167633, 145167633, 213995, 214535, 5, 15, 540
16, 14, 17a080d, 17a080d, 214675, 214905, 6, 0, 230
16, 14, 227befd, 227befd, 215265, 215585, 6, 1, 320
16, 14, 30a8609, 30a8609, 215885, 216295, 6, 2, 410
16, 14, 4461a88, 4461a88, 216515, 217015, 6, 3, 500
16, 14, 1023ff25, 31023ff25, 217215, 217485, 6, 4, 270
16, 14, 2065bff7, 32065bff7, 217855, 218035, 6, 5, 180
16, 14, 302bedf0, 3302bedf0, 218525, 218615, 6, 6, 90
16, 14, 403d8cf1, 3403d8cf1, 219215, 219395, 6, 7, 180
16, 14, 5154c896, 25154c896, 219905, 220085, 6, 8, 180
16, 14, 5254c80a, 25254c80a, 220515, 220785, 6, 9, 270
16, 14, 532e47d5, 2532e47d5, 221205, 221565, 6, 10, 360
16, 14, 541085cb, 2541085cb, 221905, 222355, 6, 11, 450
16, 14, 15143d4c, 115143d4c, 222585, 223125, 6, 12, 540
16, 14, 250b0f2d, 1250b0f2d, 223295, 223745, 6, 13, 450
16, 14, 3578ee65, 13578ee65, 223965, 224325, 6, 14, 360
16, 14, 453e16df, 1453e16df, 224615, 225065, 6, 15, 450
16, 14, 11bf978, 11bf978, 225245, 225565, 7, 0, 320
16, 14, 22ff015, 22ff015, 225925, 226335, 7, 1, 410
16, 14, 3764f06, 3764f06, 226585, 227085, 7, 2, 500
16, 14, 413789a, 413789a, 227235, 227825, 7, 3, 590
16, 14, 1068948f, 31068948f, 227945, 228305, 7, 4, 360
16, 14, 2077cf78, 32077cf78, 228555, 228825, 7, 5, 270
16, 14, 302dbdb9, 3302dbdb9, 229255, 229435, 7, 6, 180
16, 14, 401bff94, 3401bff94, 229865, 229955, 7, 7, 90
16, 14, 513d968e, 2513d968e, 230535, 230625, 7, 8, 90
16, 14, 527a4b14, 2527a4b14, 231155, 231335, 7, 9, 180
16, 14, 5304a827, 25304a827, 231835, 232105, 7, 10, 270
16, 14, 542b9eb7, 2542b9eb7, 232495, 232855, 7, 11, 360
16, 14, 152ac5f3, 1152ac5f3, 233115, 233745, 7, 12, 630
16, 14, 25115fd3, 125115fd3, 233755, 234295, 7, 13, 540
16, 14, 35536f9e, 135536f9e, 234435, 234885, 7, 14, 450
16, 14, 4546d7f7, 14546d7f7, 235145, 235505, 7, 15, 360
16, 14, 16e0ab7, 16e0ab7, 235785, 236125, 8, 0, 340
16, 14, 20e5444, 20e5444, 236405, 236855, 8, 1, 450
16, 14, 33e1865, 33e1865, 237055, 237595, 8, 2, 540
16, 14, 4551593, 4551593, 237715, 238345, 8, 3, 630
16, 14, 1029ebaf, 31029ebaf, 238405, 238765, 8, 4, 360
16, 14, 200afe03, 3200afe03, 239075, 239345, 8, 5, 270
16, 14, 303e08b8, 3303e08b8, 239745, 239925, 8, 6, 180
16, 14, 401712a8, 3401712a8, 240365, 240455, 8, 7, 90
16, 14, 5155c626, 25155c626, 240995, 241085, 8, 8, 90
16, 14, 5263ccfc, 25263ccfc, 241685, 241865, 8, 9, 180
16, 14, 5344d0c6, 25344d0c6, 242355, 242625, 8, 10, 270
16, 14, 5471b63f, 25471b63f, 243025, 243385, 8, 11, 360
16, 14, 155b3aea, 1155b3aea, 243735, 244365, 8, 12, 630
16, 14, 2521ec78, 12521ec78, 244365, 244905, 8, 13, 540
16, 14, 35181203, 135181203, 245035, 245485, 8, 14, 450
16, 14, 450eb40c, 1450eb40c, 245725, 246085, 8, 15, 360
16, 14, 1750d8c, 1750d8c, 246425, 246835, 9, 0, 410
16, 14, 21138f1, 21138f1, 247105, 247465, 9, 1, 360
16, 14, 31bdf77, 31bdf77, 247725, 248175, 9, 2, 450
16, 14, 40758e4, 40758e4, 248405, 248945, 9, 3, 540
16, 14, 10040764, 310040764, 249065, 249515, 9, 4, 450
16, 14, 201218ab, 3201218ab, 249725, 250085, 9, 5, 360
16, 14, 303dbb3b, 3303dbb3b, 250375, 250645, 9, 6, 270
16, 14, 4023349f, 34023349f, 251075, 251255, 9, 7, 180
16, 14, 514bfba3, 2514bfba3, 251705, 251885, 9, 8, 180
16, 14, 526495b4, 2526495b4, 252355, 252445, 9, 9, 90
16, 14, 53045878, 253045878, 253065, 253245, 9, 10, 180
16, 14, 543c5f89, 2543c5f89, 253715, 253985, 9, 11, 270
16, 14, 157d0d00, 1157d0d00, 254405, 254945, 9, 12, 540
16, 14, 25645c61, 125645c61, 255085, 255535, 9, 13, 450
16, 14, 353554ad, 1353554ad, 255745, 256105, 9, 14, 360
16, 14, 457cf325, 1457cf325, 256445, 256715, 9, 15, 270
16, 14, 16aaf5d, 16aaf5d, 257115, 257615, 10, 0, 500
16, 14, 24c3c18, 24c3c18, 257765, 258215, 10, 1, 450
16, 14, 366c9fc, 366c9fc, 258475, 258835, 10, 2, 360
16, 14, 405822d, 405822d, 259145, 259595, 10, 3, 450
16, 14, 10083367, 310083367, 259785, 260325, 10, 4, 540
16, 14, 204fa14f, 3204fa14f, 260455, 260905, 10, 5, 450
16, 14, 301c9e13, 3301c9e13, 261105, 261465, 10, 6, 360
16, 14, 4002dede, 34002dede, 261785, 262055, 10, 7, 270
16, 14, 515ab320, 2515ab320, 262465, 262735, 10, 8, 270
16, 14, 527ce321, 2527ce321, 263145, 263325, 10, 9, 180
16, 14, 536aad5e, 2536aad5e, 263835, 263925, 10, 10, 90
16, 14, 541e6f33, 2541e6f33, 264475, 264655, 10, 11, 180
16, 14, 152d24ea, 1152d24ea, 265175, 265625, 10, 12, 450
16, 14, 2540244f, 12540244f, 265865, 266225, 10, 13, 360
16, 14, 3528f8a3, 13528f8a3, 266535, 266805, 10, 14, 270
16, 14, 454d0b33, 1454d0b33, 267145, 267325, 10, 15, 180
16, 14, 127e346, 127e346, 267785, 268375, 11, 0, 590
16, 14, 21c6af9, 21c6af9, 268475, 269015, 11, 1, 540
16, 14, 3657aa7, 3657aa7, 269085, 269535, 11, 2, 450
16, 14, 46caea8, 46caea8, 269795, 270155, 11, 3, 360
16, 14, 10764679, 310764679, 270415, 271045, 11, 4, 630
16, 14, 2071d2de, 32071d2de, 271095, 271635, 11, 5, 540
16, 14, 3050dcd4, 33050dcd4, 271795, 272245, 11, 6, 450
16, 14, 40486843, 340486843, 272465, 272825, 11, 7, 360
16, 14, 5105096e, 25105096e, 273155, 273515, 11, 8, 360
16, 14, 524954fa, 2524954fa, 273825, 274095, 11, 9, 270
16, 14, 53637b44, 253637b44, 274515, 274695, 11, 10, 180
16, 14, 545c7dcb, 2545c7dcb, 275185, 275275, 11, 11, 90
16, 14, 1566edc9, 11566edc9, 275825, 276185, 11, 12, 360
16, 14, 252d3027, 1252d3027, 276455, 276725, 11, 13, 270
16, 14, 356879b4, 1356879b4, 277105, 277285, 11, 14, 180
16, 14, 45010d59, 145010d59, 277775, 277865, 11, 15, 90
16, 14, 1559e67, 1559e67, 278405, 278685, 12, 0, 280
16, 14, 254ba7a, 254ba7a, 279045, 279315, 12, 1, 270
16, 14, 313502a, 313502a, 279685, 279865, 12, 2, 180
16, 14, 42dc583, 42dc583, 280375, 280465, 12, 3, 90
16, 14, 1042cdc1, 31042cdc1, 281055, 281415, 12, 4, 360
16, 14, 202c27ea, 3202c27ea, 281755, 282165, 12, 5, 410
16, 14, 300f2ab5, 3300f2ab5, 282415, 282915, 12, 6, 500
16, 14, 40523be9, 340523be9, 283125, 283735, 12, 7, 610
16, 14, 5176ffbc, 25176ffbc, 283775, 284405, 12, 8, 630
16, 14, 520b3ee8, 2520b3ee8, 284465, 284905, 12, 9, 440
16, 14, 535d3302, 2535d3302, 285155, 285505, 12, 10, 350
16, 14, 5456d90c, 25456d90c, 285785, 286025, 12, 11, 240
16, 14, 156eb6ea, 1156eb6ea, 286465, 286555, 12, 12, 90
16, 14, 25143477, 125143477, 287145, 287325, 12, 13, 180
16, 14, 3502ba31, 13502ba31, 287855, 288125, 12, 14, 270
16, 14, 4554b73d, 14554b73d, 288475, 288835, 12, 15, 360
16, 14, 15efc9c, 15efc9c, 289155, 289305, 13, 0, 150
16, 14, 23d79f4, 23d79f4, 289795, 290095, 13, 1, 300
16, 14, 36e9ad8, 36e9ad8, 290475, 290685, 13, 2, 210
16, 14, 439f99d, 439f99d, 291115, 291235, 13, 3, 120
16, 14, 10680b31, 310680b31, 291815, 292265, 13, 4, 450
16, 14, 20280db2, 320280db2, 292525, 292885, 13, 5, 360
16, 14, 3020409f, 33020409f, 293205, 293655, 13, 6, 450
16, 14, 404bfea1, 3404bfea1, 293895, 294435, 13, 7, 540
16, 14, 516d6739, 2516d6739, 294545, 295085, 13, 8, 540
16, 14, 52464e7d, 252464e7d, 295245, 295695, 13, 9, 450
16, 14, 537486af, 2537486af, 295875, 296235, 13, 10, 360
16, 14, 546a5f94, 2546a5f94, 296575, 296845, 13, 11, 270
16, 14, 156fa2b3, 1156fa2b3, 297225, 297405, 13, 12, 180
16, 14, 25205b7a, 125205b7a, 297855, 297945, 13, 13, 90
16, 14, 3539ea67, 13539ea67, 298525, 298705, 13, 14, 180
16, 14, 45174223, 145174223, 299145, 299415, 13, 15, 270
16, 14, 124d9f9, 124d9f9, 299815, 300055, 14, 0, 240
16, 14, 272a439, 272a439, 300405, 300795, 14, 1, 390
16, 14, 36e4f38, 36e4f38, 301045, 301345, 14, 2, 300
16, 14, 422ea42, 422ea42, 301725, 301935, 14, 3, 210
16, 14, 102a29c7, 3102a29c7, 302385, 302925, 14, 4, 540
16, 14, 2052fa34, 32052fa34, 303095, 303545, 14, 5, 450
16, 14, 3068674d, 33068674d, 303715, 304075, 14, 6, 360
16, 14, 40167fd0, 340167fd0, 304395, 304845, 14, 7, 450
16, 14, 5110dde0, 25110dde0, 305075, 305525, 14, 8, 450
16, 14, 5254a249, 25254a249, 305755, 306115, 14, 9, 360
16, 14, 531767ee, 2531767ee, 306415, 306685, 14, 10, 270
16, 14, 540f35a7, 2540f35a7, 307045, 307225, 14, 11, 180
16, 14, 1563efeb, 11563efeb, 307655, 307925, 14, 12, 270
16, 14, 254a425f, 1254a425f, 308305, 308485, 14, 13, 180
16, 14, 35443cae, 135443cae, 308965, 309055, 14, 14, 90
16, 14, 453412db, 1453412db, 309665, 309845, 14, 15, 180
16, 14, 17de218, 17de218, 310305, 310635, 15, 0, 330
16, 14, 201ed5b, 201ed5b, 310955, 311435, 15, 1, 480
16, 14, 36bafbe, 36bafbe, 311665, 312055, 15, 2, 390
16, 14, 43af525, 43af525, 312315, 312615, 15, 3, 300
16, 14, 1043f6eb, 31043f6eb, 313005, 313635, 15, 4, 630
16, 14, 207c9916, 3207c9916, 313625, 314165, 15, 5, 540
16, 14, 3055cde6, 33055cde6, 314315, 314765, 15, 6, 450
16, 14, 40232354, 340232354, 314935, 315295, 15, 7, 360
16, 14, 513d7b5e, 2513d7b5e, 315625, 315985, 15, 8, 360
16, 14, 52017abc, 252017abc, 316335, 316605, 15, 9, 270
16, 14, 53620abb, 253620abb, 316945, 317125, 15, 10, 180
16, 14, 5421135c, 25421135c, 317585, 317675, 15, 11, 90
16, 14, 1533eae6, 11533eae6, 318255, 318615, 15, 12, 360
16, 14, 252daeea, 1252daeea, 318945, 319215, 15, 13, 270
16, 14, 3553a39a, 13553a39a, 319635, 319815, 15, 14, 180
16, 14, 4520a56e, 14520a56e, 320265, 320355, 15, 15, 90
16, 14, 1de51bd, 1de51bd, 321885, 321935, 0, 0, 50
16, 14, 2dc479d, 2dc479d, 322485, 322605, 0, 1, 120
16, 14, 3c411a5, 3c411a5, 323145, 323355, 0, 2, 210
16, 14, 498083d, 498083d, 323845, 324145, 0, 3, 300
16, 14, 10c38c9d, 310c38c9d, 324505, 324595, 0, 4, 90
16, 14, 20f7c718, 320f7c718, 325145, 325285, 0, 5, 140
16, 14, 30d22c97, 330d22c97, 325775, 326005, 0, 6, 230
16, 14, 40a8545f, 340a8545f, 326465, 326805, 0, 7, 340
16, 14, 519c32cb, 2519c32cb, 327165, 327525, 0, 8, 360
16, 14, 52991560, 252991560, 327875, 328285, 0, 9, 410
16, 14, 53c08216, 253c08216, 328505, 329005, 0, 10, 500
16, 14, 5490a1af, 25490a1af, 329185, 329775, 0, 11, 590
16, 14, 15dea481, 115dea481, 329885, 330245, 0, 12, 360
16, 14, 25b0ddfc, 125b0ddfc, 330585, 330855, 0, 13, 270
16, 14, 35a7bb0c, 135a7bb0c, 331195, 331555, 0, 14, 360
16, 14, 45f7b9ce, 145f7b9ce, 331825, 332455, 0, 15, 630
16, 14, 1aad7f2, 1aad7f2, 332495, 332555, 1, 0, 60
16, 14, 2d0a6d5, 2d0a6d5, 333085, 333175, 1, 1, 90
16, 14, 38c1dec, 38c1dec, 333715, 333895, 1, 2, 180
16, 14, 49bc84b, 49bc84b, 334385, 334655, 1, 3, 270
16, 14, 10fd4bdb, 310fd4bdb, 335035, 335215, 1, 4, 180
16, 14, 209a3639, 3209a3639, 335715, 335865, 1, 5, 150
16, 14, 30f066eb, 330f066eb, 336325, 336565, 1, 6, 240
16, 14, 40e7044b, 340e7044b, 337005, 337335, 1, 7, 330
16, 14, 51d7b7ea, 251d7b7ea, 337675, 338125, 1, 8, 450
16, 14, 52dcdc23, 252dcdc23, 338355, 338715, 1, 9, 360
16, 14, 53e2d6c6, 253e2d6c6, 339025, 339475, 1, 10, 450
16, 14, 54869bb5, 254869bb5, 339735, 340275, 1, 11, 540
16, 14, 15cf7653, 115cf7653, 340415, 340685, 1, 12, 270
16, 14, 25d76d44, 125d76d44, 341075, 341435, 1, 13, 360
16, 14, 35b9a8be, 135b9a8be, 341785, 342235, 1, 14, 450
16, 14, 45ea7bb2, 145ea7bb2, 342495, 343035, 1, 15, 540
16, 14, 1adffe7, 1adffe7, 343155, 343305, 2, 0, 150
16, 14, 2cf5297, 2cf5297, 343745, 343925, 2, 1, 180
16, 14, 3d6abf3, 3d6abf3, 344415, 344505, 2, 2, 90
16, 14, 4dfa5fb, 4dfa5fb, 345045, 345225, 2, 3, 180
16, 14, 10deb711, 310deb711, 345695, 345965, 2, 4, 270
16, 14, 20f0e376, 320f0e376, 346345, 346585, 2, 5, 240
16, 14, 30b38490, 330b38490, 346975, 347305, 2, 6, 330
16, 14, 40ce01b5, 340ce01b5, 347645, 348065, 2, 7, 420
16, 14, 51caa1a0, 251caa1a0, 348285, 348825, 2, 8, 540
16, 14, 52a06af6, 252a06af6, 348905, 349355, 2, 9, 450
16, 14, 53c0471f, 253c0471f, 349575, 349935, 2, 10, 360
16, 14, 54c45623, 254c45623, 350185, 350635, 2, 11, 450
16, 14, 15e437fa, 115e437fa, 350895, 351075, 2, 12, 180
16, 14, 25f1dc46, 125f1dc46, 351525, 351795, 2, 13, 270
16, 14, 35d9df56, 135d9df56, 352175, 352535, 2, 14, 360
16, 14, 45d63ccf, 145d63ccf, 352865, 353315, 2, 15, 450
16, 14, 1baa063, 1baa063, 353475, 353715, 3, 0, 240
16, 14, 298ae84, 298ae84, 354025, 354295, 3, 1, 270
16, 14, 3b23dd0, 3b23dd0, 354705, 354885, 3, 2, 180
16, 14, 4e1c516, 4e1c516, 355385, 355475, 3, 3, 90
16, 14, 10a05194, 310a05194, 356025, 356385, 3, 4, 360
16, 14, 20ae76fc, 320ae76fc, 356695, 357025, 3, 5, 330
16, 14, 30cf734a, 330cf734a, 357395, 357815, 3, 6, 420
16, 14, 40c54f4d, 340c54f4d, 358005, 358515, 3, 7, 510
16, 14, 51b9844e, 251b9844e, 358685, 359315, 3, 8, 630
16, 14, 52e8c6fa, 252e8c6fa, 359315, 359855, 3, 9, 540
16, 14, 53caabf6, 253caabf6, 359925, 360375, 3, 10, 450
16, 14, 54cd6471, 254cd6471, 360605, 360965, 3, 11, 360
16, 14, 15e88a3c, 115e88a3c, 361295, 361385, 3, 12, 90
16, 14, 25b788e9, 125b788e9, 361955, 362135, 3, 13, 180
16, 14, 35d22772, 135d22772, 362615, 362885, 3, 14, 270
16, 14, 45cc7afd, 145cc7afd, 363265, 363625, 3, 15, 360
16, 14, 1e69042, 1e69042, 363885, 363935, 4, 0, 50
16, 14, 2c27a32, 2c27a32, 364505, 364645, 4, 1, 140
16, 14, 3cbf603, 3cbf603, 365115, 365345, 4, 2, 230
16, 14, 4f38d89, 4f38d89, 365735, 366075, 4, 3, 340
16, 14, 10ce79c5, 310ce79c5, 366345, 366435, 4, 4, 90
16, 14, 2083c7f6, 32083c7f6, 367025, 367185, 4, 5, 160
16, 14, 30d28b44, 330d28b44, 367665, 367915, 4, 6, 250
16, 14, 408a852e, 3408a852e, 368285, 368625, 4, 7, 340
16, 14, 51aa4137, 251aa4137, 368955, 369315, 4, 8, 360
16, 14, 52da55b1, 252da55b1, 369655, 370065, 4, 9, 410
16, 14, 53d9f8fe, 253d9f8fe, 370295, 370795, 4, 10, 500
16, 14, 54abf794, 254abf794, 370955, 371565, 4, 11, 610
16, 14, 159b7021, 1159b7021, 371565, 371925, 4, 12, 360
16, 14, 259cb2eb, 1259cb2eb, 372275, 372625, 4, 13, 350
16, 14, 358b5f17, 1358b5f17, 372975, 373415, 4, 14, 440
16, 14, 45a228dd, 145a228dd, 373595, 374225, 4, 15, 630
16, 14, 1b4c3e5, 1b4c3e5, 374225, 374365, 5, 0, 140
16, 14, 2ab0a65, 2ab0a65, 374865, 375135, 5, 1, 270
16, 14, 3b4091f, 3b4091f, 375535, 375895, 5, 2, 360
16, 14, 49f452b, 49f452b, 376145, 376595, 5, 3, 450
16, 14, 10d219a6, 310d219a6, 376845, 377025, 5, 4, 180
16, 14, 20a2ab81, 320a2ab81, 377555, 377645, 5, 5, 90
16, 14, 30e618b3, 330e618b3, 378245, 378425, 5, 6, 180
16, 14, 40d937e4, 340d937e4, 378915, 379185, 5, 7, 270
16, 14, 51a52c9e, 251a52c9e, 379555, 379825, 5, 8, 270
16, 14, 52814a32, 252814a32, 380245, 380605, 5, 9, 360
16, 14, 53a600ce, 253a600ce, 380865, 381315, 5, 10, 450
16, 14, 54b9c455, 254b9c455, 381505, 382045, 5, 11, 540
16, 14, 15a277cd, 115a277cd, 382145, 382595, 5, 12, 450
16, 14, 25d101b3, 125d101b3, 382855, 383215, 5, 13, 360
16, 14, 35c05f40, 135c05f40, 383505, 383955, 5, 14, 450
16, 14, 45ac514e, 145ac514e, 384155, 384695, 5, 15, 540
16, 14, 19287a4, 19287a4, 384855, 385085, 6, 0, 230
16, 14, 2c5c43e, 2c5c43e, 385475, 385835, 6, 1, 360
16, 14, 3ec898f, 3ec898f, 386085, 386535, 6, 2, 450
16, 14, 4aad30a, 4aad30a, 386775, 387315, 6, 3, 540
16, 14, 1091bfdf, 31091bfdf, 387405, 387675, 6, 4, 270
16, 14, 20b3cff4, 320b3cff4, 388045, 388225, 6, 5, 180
16, 14, 3096752d, 33096752d, 388725, 388815, 6, 6, 90
16, 14, 40b15917, 340b15917, 389375, 389555, 6, 7, 180
16, 14, 51d279e9, 251d279e9, 390035, 390215, 6, 8, 180
16, 14, 52dfbc21, 252dfbc21, 390715, 390985, 6, 9, 270
16, 14, 53cc641e, 253cc641e, 391415, 391775, 6, 10, 360
16, 14, 54cbc5a8, 254cbc5a8, 392125, 392575, 6, 11, 450
16, 14, 15cc6bbd, 115cc6bbd, 392825, 393365, 6, 12, 540
16, 14, 25997408, 125997408, 393495, 393945, 6, 13, 450
16, 14, 35b891ea, 135b891ea, 394135, 394495, 6, 14, 360
16, 14, 45d6f953, 145d6f953, 394765, 395215, 6, 15, 450
16, 14, 1ef2fef, 1ef2fef, 395385, 395705, 7, 0, 320
16, 14, 2d748c8, 2d748c8, 395985, 396435, 7, 1, 450
16, 14, 3fe342f, 3fe342f, 396685, 397225, 7, 2, 540
16, 14, 49bcbb9, 49bcbb9, 397335, 397965, 7, 3, 630
16, 14, 10b4b25f, 310b4b25f, 397985, 398345, 7, 4, 360
16, 14, 20fe40d0, 320fe40d0, 398695, 398965, 7, 5, 270
16, 14, 30d3f812, 330d3f812, 399355, 399535, 7, 6, 180
16, 14, 40cc9f1b, 340cc9f1b, 400035, 400125, 7, 7, 90
16, 14, 51f1b83f, 251f1b83f, 400725, 400815, 7, 8, 90
16, 14, 52f68712, 252f68712, 401345, 401525, 7, 9, 180
16, 14, 53ea15d0, 253ea15d0, 402035, 402305, 7, 10, 270
16, 14, 54e49449, 254e49449, 402665, 403025, 7, 11, 360
16, 14, 15bb3912, 115bb3912, 403285, 403915, 7, 12, 630
16, 14, 25cd5247, 125cd5247, 403985, 404525, 7, 13, 540
16, 14, 35e64966, 135e64966, 404685, 405135, 7, 14, 450
16, 14, 45ea6607, 145ea6607, 405395, 405755, 7, 15, 360
16, 14, 1bec10b, 1bec10b, 406055, 406395, 8, 0, 340
16, 14, 2b6e654, 2b6e654, 406665, 407115, 8, 1, 450
16, 14, 3be88d8, 3be88d8, 407355, 407895, 8, 2, 540
16, 14, 4f44422, 4f44422, 407975, 408605, 8, 3, 630
16, 14, 10fa7c95, 310fa7c95, 408605, 408965, 8, 4, 360
16, 14, 20d0df07, 320d0df07, 409265, 409535, 8, 5, 270
16, 14, 30cd14a7, 330cd14a7, 409895, 410075, 8, 6, 180
16, 14, 40ba9f77, 340ba9f77, 410515, 410605, 8, 7, 90
16, 14, 518d802e, 2518d802e, 411165, 411255, 8, 8, 90
16, 14, 52b4b066, 252b4b066, 411785, 411965, 8, 9, 180
16, 14, 53d93f8f, 253d93f8f, 412435, 412705, 8, 10, 270
16, 14, 54f3dc2d, 254f3dc2d, 413125, 413485, 8, 11, 360
16, 14, 15e74729, 115e74729, 413795, 414425, 8, 12, 630
16, 14, 25dad0fd, 125dad0fd, 414435, 414975, 8, 13, 540
16, 14, 35e0642a, 135e0642a, 415145, 415595, 8, 14, 450
16, 14, 45c7de5c, 145c7de5c, 415845, 416205, 8, 15, 360
16, 14, 1c46b38, 1c46b38, 416505, 416855, 9, 0, 350
16, 14, 2981faf, 2981faf, 417135, 417495, 9, 1, 360
16, 14, 398f028, 398f028, 417785, 418235, 9, 2, 450
16, 14, 4afb198, 4afb198, 418415, 418955, 9, 3, 540
16, 14, 108f2739, 3108f2739, 419115, 419565, 9, 4, 450
16, 14, 209c18c9, 3209c18c9, 419815, 420155, 9, 5, 340
16, 14, 308d7618, 3308d7618, 420485, 420735, 9, 6, 250
16, 14, 40cf9cea, 340cf9cea, 421185, 421345, 9, 7, 160
16, 14, 51eff6bf, 251eff6bf, 421865, 422045, 9, 8, 180
16, 14, 52e02c95, 252e02c95, 422535, 422625, 9, 9, 90
16, 14, 53dc16d5, 253dc16d5, 423215, 423395, 9, 10, 180
16, 14, 5481b042, 25481b042, 423915, 424185, 9, 11, 270
16, 14, 15a56b66, 115a56b66, 424595, 425135, 9, 12, 540
16, 14, 25812728, 125812728, 425225, 425675, 9, 13, 450
16, 14, 35ff449f, 135ff449f, 425935, 426295, 9, 14, 360
16, 14, 45d8541c, 145d8541c, 426635, 426905, 9, 15, 270
16, 14, 192c7ab, 192c7ab, 427305, 427745, 10, 0, 440
16, 14, 2bd3cb9, 2bd3cb9, 427935, 428385, 10, 1, 450
16, 14, 3e1f818, 3e1f818, 428605, 428965, 10, 2, 360
16, 14, 4ec94d7, 4ec94d7, 429225, 429675, 10, 3, 450
16, 14, 10f39a74, 310f39a74, 429865, 430405, 10, 4, 540
16, 14, 208b8670, 3208b8670, 430495, 430925, 10, 5, 430
16, 14, 30be2795, 330be2795, 431195, 431535, 10, 6, 340
16, 14, 4096bf52, 34096bf52, 431855, 432105, 10, 7, 250
16, 14, 51a498ad, 251a498ad, 432495, 432765, 10, 8, 270
16, 14, 5297c7d4, 25297c7d4, 433175, 433355, 10, 9, 180
16, 14, 53e67941, 253e67941, 433805, 433895, 10, 10, 90
16, 14, 54b22ae1, 254b22ae1, 434465, 434645, 10, 11, 180
16, 14, 15edd613, 115edd613, 435085, 435535, 10, 12, 450
16, 14, 25cd6bfb, 125cd6bfb, 435795, 436155, 10, 13, 360
16, 14, 35bd09a9, 135bd09a9, 436455, 436725, 10, 14, 270
16, 14, 45aa6602, 145aa6602, 437155, 437335, 10, 15, 180
16, 14, 1af6632, 1af6632, 437775, 438305, 11, 0, 530
16, 14, 28293e1, 28293e1, 438435, 438975, 11, 1, 540
16, 14, 3f46c29, 3f46c29, 439115, 439565, 11, 2, 450
16, 14, 4ee56e9, 4ee56e9, 439785, 440145, 11, 3, 360
16, 14, 10d40a00, 310d40a00, 440495, 441125, 11, 4, 630
16, 14, 20cf4b0d, 320cf4b0d, 441145, 441665, 11, 5, 520
16, 14, 30973f10, 330973f10, 441845, 442275, 11, 6, 430
16, 14, 40d7017b, 340d7017b, 442485, 442825, 11, 7, 340
16, 14, 51aadfe3, 251aadfe3, 443185, 443545, 11, 8, 360
16, 14, 52c79001, 252c79001, 443885, 444155, 11, 9, 270
16, 14, 53ab52c3, 253ab52c3, 444545, 444725, 11, 10, 180
16, 14, 54d49a5f, 254d49a5f, 445155, 445245, 11, 11, 90
16, 14, 15b0f2be, 115b0f2be, 445765, 446125, 11, 12, 360
16, 14, 25bb0fee, 125bb0fee, 446395, 446665, 11, 13, 270
16, 14, 35dc6a1d, 135dc6a1d, 447065, 447245, 11, 14, 180
16, 14, 45c22efa, 145c22efa, 447685, 447775, 11, 15, 90
16, 14, 1aef964, 1aef964, 448305, 448645, 12, 0, 340
16, 14, 2ba62eb, 2ba62eb, 448895, 449165, 12, 1, 270
16, 14, 3c2c085, 3c2c085, 449575, 449755, 12, 2, 180
16, 14, 4bd5a1a, 4bd5a1a, 450215, 450305, 12, 3, 90
16, 14, 10863c2d, 310863c2d, 450885, 451245, 12, 4, 360
16, 14, 20d058be, 320d058be, 451545, 451955, 12, 5, 410
16, 14, 30d62511, 330d62511, 452185, 452685, 12, 6, 500
16, 14, 40c3f6ac, 340c3f6ac, 452835, 453425, 12, 7, 590
16, 14, 5182c3b1, 25182c3b1, 453445, 454075, 12, 8, 630
16, 14, 52a517e9, 252a517e9, 454105, 454645, 12, 9, 540
16, 14, 5392c44a, 25392c44a, 454765, 455215, 12, 10, 450
16, 14, 54f68e62, 254f68e62, 455445, 455805, 12, 11, 360
16, 14, 15c2c10d, 115c2c10d, 456145, 456235, 12, 12, 90
16, 14, 25fd8bb0, 125fd8bb0, 456755, 456935, 12, 13, 180
16, 14, 35dad931, 135dad931, 457465, 457735, 12, 14, 270
16, 14, 45f2c05e, 145f2c05e, 458155, 458515, 12, 15, 360
16, 14, 1db37a2, 1db37a2, 458835, 459165, 13, 0, 330
16, 14, 29027b2, 29027b2, 459405, 459765, 13, 1, 360
16, 14, 3d80461, 3d80461, 460025, 460295, 13, 2, 270
16, 14, 4acc23f, 4acc23f, 460635, 460815, 13, 3, 180
16, 14, 10852c43, 310852c43, 461335, 461785, 13, 4, 450
16, 14, 209b41ac, 3209b41ac, 462035, 462395, 13, 5, 360
16, 14, 30936382, 330936382, 462725, 463175, 13, 6, 450
16, 14, 40f34835, 340f34835, 463425, 463965, 13, 7, 540
16, 14, 51ef1157, 251ef1157, 464075, 464615, 13, 8, 540
16, 14, 52e21cf0, 252e21cf0, 464725, 465175, 13, 9, 450
16, 14, 53833010, 253833010, 465395, 465755, 13, 10, 360
16, 14, 54dca35b, 254dca35b, 466025, 466295, 13, 11, 270
16, 14, 15a201ec, 115a201ec, 466715, 466895, 13, 12, 180
16, 14, 25a28497, 125a28497, 467375, 467465, 13, 13, 90
16, 14, 35f35496, 135f35496, 468005, 468185, 13, 14, 180
16, 14, 45b7ead4, 145b7ead4, 468635, 468905, 13, 15, 270
16, 14, 18abfec, 18abfec, 469345, 469765, 14, 0, 420
16, 14, 28364d5, 28364d5, 469925, 470375, 14, 1, 450
16, 14, 3bd1604, 3bd1604, 470605, 470965, 14, 2, 360
16, 14, 4a08c0d, 4a08c0d, 471245, 471515, 14, 3, 270
16, 14, 1095b642, 31095b642, 471945, 472485, 14, 4, 540
16, 14, 20c76f26, 320c76f26, 472645, 473095, 14, 5, 450
16, 14, 3084362c, 33084362c, 473275, 473635, 14, 6, 360
16, 14, 40ba9c16, 340ba9c16, 473885, 474335, 14, 7, 450
16, 14, 51fa08fa, 251fa08fa, 474515, 474965, 14, 8, 450
16, 14, 5291813f, 25291813f, 475175, 475535, 14, 9, 360
16, 14, 53caff18, 253caff18, 475825, 476095, 14, 10, 270
16, 14, 54cd1a49, 254cd1a49, 476535, 476715, 14, 11, 180
16, 14, 15f77503, 115f77503, 477215, 477485, 14, 12, 270
16, 14, 258cee98, 1258cee98, 477845, 478025, 14, 13, 180
16, 14, 3582c83d, 13582c83d, 478495, 478585, 14, 14, 90
16, 14, 45cb996a, 145cb996a, 479155, 479335, 14, 15, 180
16, 14, 1cd74dc, 1cd74dc, 479855, 480365, 15, 0, 510
16, 14, 29c9a12, 29c9a12, 480425, 480965, 15, 1, 540
16, 14, 3a5191a, 3a5191a, 481035, 481485, 15, 2, 450
16, 14, 4eefe80, 4eefe80, 481745, 482105, 15, 3, 360
16, 14, 1097f801, 31097f801, 482365, 482995, 15, 4, 630
16, 14, 209c4033, 3209c4033, 483005, 483545, 15, 5, 540
16, 14, 3085059f, 33085059f, 483615, 484065, 15, 6, 450
16, 14, 40cb8eeb, 340cb8eeb, 484275, 484635, 15, 7, 360
16, 14, 51e016eb, 251e016eb, 484925, 485285, 15, 8, 360
16, 14, 52ef47c5, 252ef47c5, 485595, 485865, 15, 9, 270
16, 14, 53884c11, 253884c11, 486295, 486475, 15, 10, 180
16, 14, 54f61843, 254f61843, 487005, 487095, 15, 11, 90
16, 14, 15f0afee, 115f0afee, 487635, 487995, 15, 12, 360
16, 14, 25eb0595, 125eb0595, 488325, 488595, 15, 13, 270
16, 14, 35bb31f3, 135bb31f3, 488935, 489115, 15, 14, 180
16, 14, 45880bd8, 145880bd8, 489585, 489675, 15, 15, 90
